000 000 000 000 000 000 000 000 000 000 000 000 000 000 000 000 000 000 000 000 000 000 000 000 000 000 000   000 000 000 000 000 000 000 000      000      000      000 000 000 
000 000 000 000 000 000 000 000 000 000 000 000 000 000 000 000 000 000 000 000 000 000 000 000 000 000 000   000 000 000 000 000 000 000 000      000      000      000 000 000 
000 000 000 000 000 000 000 000 000 000 000 000 000 000 000 000 000 000 000 000 000 000 000 000 000 000 000   000 000 000 000 000 000 000 000      000      000      000 000 000 
000 000 000 000 000 000 000 000 000 000 000 000 000 000 000 000 000 000 000 000 000 000 000 000 000 000 000   000 000 000 000 000 000 000 000      000      000      000 000 000 
000 000 000 000 000 000 000 000 000 000 000 000 000 000 000 000 000 000 000 000 000 000 000 000 000 000 000   000 000 000 000 000 000 000 000      000      000      000 000 000 
000 000 000 000 000 000 000 000 000 000 000 000 000 000 000 000 000 000 000 000 000 000 000 000 000 000 000   000 000 000 000 000 000 000 000      000      000      000 000 000 
000 000 000 000 000 000 000 000 000 000 000 000 000 000 000 000 000 000 000 000 000 000 000 000 000 000 000   000 000 000 000 000 000 000 000      000      000      000 000 000 
000 000 000 000 000 000 000 000 000 000 000 000 000 000 000 000 000 000 000 000 000 000 000 000 000 000 000   000 000 000 000 000 000 000 000      000      000      000 000 000 
000 000 000 000 000 000 000 000 000 000 000 000 000 000 000 000 000 000 000 000 000 000 000 000 000 000 000   000 000 000 000 000 000 000 000      000      000      000 000 000 
000 000 000 000 000 000 000 000 000 000 000 000 000 000 000 000 000 000 000 000 000 000 000 000 000 000 000   000 000 000 000 000 000 000 000      000      000      000 000 000 
000 000 000 000 000 000 000 000 000 000 000 000 000 000 000 000 000 000 000 000 000 000 000 000 000 000 000   000 000 000 000 000 000 000 000      000      000      000 000 000 
000 000 000 000 000 000 000 000 000 000 000 000 000 000 000 000 000 097 097 097 097 097 097 000 000 000 000   000 000 000 000 000 000 000 000      000      000      000 000 000 
000 000 000 000 000 000 000 000 097 097 097 097 097 097 000 000 000 000 000 000 000 000 000 000 000 000 000   000 000 000 000 000 000 000 000      000      000      000 000 000
000 000 000 000 000 000 000 000 000 000 000 000 000 000 000 000 000 114 115 118 119 124 125 000 000 000 000   000 000 062 062 062 062 062 062      066      067      068 062 062
000 000 000 000 000 000 000 000 100 101 093 094 106 107 000 000 000 112 113 118 119 126 127 000 000 051 055   000 000 062 062 069 075 062 062      062      078      062 062 062
000 000 000 000 000 000 000 000 102 094 093 094 108 109 000 000 000 114 094 120 121 124 125 000 000 052 056   059 000 062 062 070 076 062 062      079      082      085 062 062
050 050 050 050 050 050 050 050 093 103 093 094 106 107 050 050 050 112 113 093 121 124 125 050 050 053 057 65596 050 062 062 071 077 062 088 131152 131155 131158 088 062
049 049 049 049 049 049 049 049 091 092 091 092 091 092 049 049 049 091 092 091 092 091 092 049 049 054 058   061 049 090 090 090 090 090 089      081      084      087 089 090
000 000 000 000 000 000 000 000 000 000 000 000 000 000 000 000 000 000 000 000 000 000 000 000 000 000 000   000 000 000 000 000 000 000 000      000      000      000 000 000
000 000 000 000 000 000 000 000 000 000 000 000 000 000 000 000 000 000 000 000 000 000 000 000 000 000 000   000 000 000 000 000 000 000 000      000      000      000 000 000
;                                                                                                                                                                    
001 001 001 001 001 001 001 001 001 001 001 001 001 001 001 001 001 001 001 001 001 001 001 001 001 001 001   001 001 001 001 001 001 001 001      001      001      001 001 001
001 000 000 000 000 000 000 000 000 000 000 000 000 000 000 000 000 000 000 000 000 000 000 000 000 000 000   000 000 000 000 000 000 000 000      000      000      000 000 001
001 000 000 000 000 000 000 000 000 000 000 000 000 000 000 000 000 000 000 000 000 000 000 000 000 000 000   000 000 000 000 000 000 000 000      000      000      000 000 001
001 000 000 000 000 000 000 000 000 000 000 000 000 000 000 000 000 000 000 000 000 000 000 000 000 000 000   000 000 000 000 000 000 000 000      000      000      000 000 001
001 000 000 000 000 000 000 000 000 000 000 000 000 000 000 000 000 000 000 000 000 000 000 000 000 000 000   000 000 000 000 000 000 000 000      000      000      000 000 001
001 000 000 000 000 000 000 000 000 000 000 000 000 000 000 000 000 000 000 000 000 000 000 000 000 000 000   000 000 000 000 000 000 000 000      000      000      000 000 001
001 000 000 000 000 000 000 000 000 000 000 000 000 000 000 000 000 000 000 000 000 000 000 000 000 000 000   000 000 000 000 000 000 000 000      000      000      000 000 001
001 000 000 000 000 000 000 000 000 000 000 000 000 000 000 000 000 000 000 000 000 000 000 000 000 000 000   000 000 000 000 000 000 000 000      000      000      000 000 001
001 000 000 000 000 000 000 000 000 000 000 000 000 000 000 000 000 000 000 000 000 000 000 000 000 000 000   000 000 000 000 000 000 000 000      000      000      000 000 001
001 000 000 000 000 000 000 000 000 000 000 000 000 000 000 000 000 000 000 000 000 000 000 000 000 000 000   000 000 000 000 000 000 000 000      000      000      000 000 001
001 000 000 000 000 000 000 000 000 000 000 000 000 000 000 000 000 000 000 000 000 000 000 000 000 000 000   000 000 000 000 000 000 000 000      000      000      000 000 001
001 000 000 000 000 000 000 000 000 000 000 000 000 000 000 000 000 000 000 000 000 000 000 000 000 000 000   000 000 000 000 000 000 000 000      000      000      000 000 001
001 000 000 000 000 000 000 000 000 000 000 000 000 000 000 000 000 110 111 116 117 122 123 000 000 000 000   000 000 062 062 062 062 062 062      062      062      062 062 062
001 000 000 000 000 000 000 000 098 099 095 096 104 105 000 000 000 000 000 000 000 000 000 000 000 000 000   000 000 000 000 000 000 000 000      000      000      000 000 001
062 062 062 062 000 000 000 000 000 000 000 000 000 000 000 000 000 000 000 000 000 000 000 000 000 000 000   000 000 000 000 000 000 000 000      000      000      000 000 001
062 062 062 062 000 000 000 000 000 000 000 000 000 000 000 000 000 000 000 000 000 000 000 000 000 000 000   000 000 000 000 000 000 000 000      000      000      000 000 001
062 062 062 062 000 000 000 000 000 000 000 000 000 000 000 000 000 000 000 000 000 000 000 000 000 000 000   000 000 000 000 000 000 000 000      000      000      000 000 001
062 062 062 062 000 000 000 000 000 000 000 000 000 000 000 000 000 000 000 000 000 000 000 000 000 000 000   000 000 000 000 000 000 000 000      000      000      000 000 001
048 048 048 048 048 048 048 048 048 048 048 048 048 048 048 048 048 048 048 048 048 048 048 048 048 048 048   048 048 048 048 048 048 048 048      048      048      048 048 048
047 047 047 047 047 047 047 047 047 047 047 047 047 047 047 047 047 047 047 047 047 047 047 047 047 047 047   047 047 047 047 047 047 047 047      047      047      047 047 047
;                                                                                                                                                                    
000 000 000 000 000 000 000 000 000 000 000 000 000 000 000 000 000 000 000 000 000 000 000 000 000 000 000   000 000 000 000 000 000 000 000      000      000      000 000 000
000 000 000 000 000 000 000 000 000 000 000 000 000 000 000 000 000 000 000 000 000 000 000 000 000 000 000   000 000 000 000 000 000 000 000      000      000      000 000 000
000 000 000 000 000 000 000 000 000 000 000 000 000 000 000 000 000 000 000 000 000 000 000 000 000 000 000   000 000 000 000 000 000 000 000      000      000      000 000 000
000 000 000 000 000 000 000 000 000 000 000 000 000 000 000 000 000 000 000 000 000 000 000 000 000 000 000   000 000 000 000 000 000 000 000      000      000      000 000 000
000 000 000 000 000 000 000 000 000 000 000 000 000 000 000 000 000 000 000 000 000 000 000 000 000 000 000   000 000 000 000 000 000 000 000      000      000      000 000 000
000 000 000 000 000 000 000 000 000 000 000 000 000 000 000 000 000 000 000 000 000 000 000 000 000 000 000   000 000 000 000 000 000 000 000      000      000      000 000 000
000 000 000 000 000 000 000 000 000 000 000 000 000 000 000 000 000 000 000 000 000 000 000 000 000 000 000   000 000 000 000 000 000 000 000      000      000      000 000 000
000 000 000 000 000 000 000 000 000 000 000 000 000 000 000 000 000 000 000 000 000 000 000 000 000 000 000   000 000 000 000 000 000 000 000      000      000      000 000 000
000 000 000 000 000 000 000 000 000 000 000 000 000 000 000 000 000 000 000 000 000 000 000 000 000 000 000   000 000 000 000 000 000 000 000      000      000      000 000 000
000 000 000 000 000 000 000 000 000 000 000 000 000 000 000 000 000 000 000 000 000 000 000 000 000 000 000   000 000 000 000 000 000 000 000      000      000      000 000 000
000 000 000 000 000 000 000 000 000 000 000 000 000 000 000 000 000 000 000 000 000 000 000 000 000 000 000   000 000 000 000 000 000 000 000      000      000      000 000 000
000 000 000 000 000 000 000 000 000 000 000 000 000 000 000 000 000 000 000 000 000 000 000 000 000 000 000   000 000 063 064 064 064 064 064      064      064      064 064 065
000 000 000 000 000 000 000 000 000 000 000 000 000 000 000 000 000 000 000 000 000 000 000 000 000 000 000   000 000 000 000 000 000 000 000      000      000      000 000 000
063 064 064 065 000 000 000 000 000 000 000 000 000 000 000 000 000 000 000 000 000 000 000 000 000 000 000   000 000 000 000 000 000 000 000      000      000      000 000 000
000 000 000 000 000 000 000 000 000 000 000 000 000 000 000 000 000 000 000 000 000 000 000 000 000 000 000   000 000 000 000 000 000 000 000      000      000      000 000 000
000 000 000 000 000 000 000 000 000 000 000 000 000 000 000 000 000 000 000 000 000 000 000 000 000 000 000   000 000 000 000 000 000 000 000      000      000      000 000 000
000 000 000 000 000 000 000 000 000 000 000 000 000 000 000 000 000 000 000 000 000 000 000 000 000 000 000   000 000 000 000 000 000 000 000      000      000      000 000 000
000 000 000 000 000 000 000 000 000 000 000 000 000 000 000 000 000 000 000 000 000 000 000 000 000 000 000   000 000 000 000 000 000 000 000      000      000      000 000 000
000 000 000 000 000 000 000 000 000 000 000 000 000 000 000 000 000 000 000 000 000 000 000 000 000 000 000   000 000 000 000 000 000 000 000      000      000      000 000 000
000 000 000 000 000 000 000 000 000 000 000 000 000 000 000 000 000 000 000 000 000 000 000 000 000 000 000   000 000 000 000 000 000 000 000      000      000      000 000 000
;
