000 000 000 000 000 000 000 000 000 000 000 000 000 000 000 000 000 000 000 000 000 000 000 000 000 000 000 000 000 000 000 000 000 000 000 000 000 000 000 000 000 000 000 000 000 000 000 000 000 000 000 000 000 000 000 000 000 000 000 000 000 000 000 000 000 000 000 000 000 000 000 000 000 000 000 000 000 000 000 000 000 000 000 000 000 000 000 000 000 035 036 036 036 036 036 036 036   036 036 037
000 000 000 000 000 000 000 000 000 000 000 000 000 000 000 000 000 000 000 000 000 000 000 000 000 000 000 000 000 000 000 000 000 000 000 000 000 000 000 000 000 000 000 000 000 000 000 000 000 000 000 000 000 000 000 000 000 000 000 000 000 000 000 000 000 000 000 000 000 000 000 000 000 000 000 000 000 000 000 000 000 000 000 000 000 000 000 000 000 035 036 036 036 036 036 036 036   036 036 037
000 000 000 000 000 000 000 000 000 000 000 000 000 000 000 000 000 000 000 000 000 000 000 000 000 000 000 000 000 000 000 000 000 000 000 000 000 000 000 000 000 000 000 000 000 000 000 000 000 000 000 000 000 000 000 000 000 000 000 000 000 000 000 000 000 000 000 000 000 000 000 000 000 000 000 000 000 000 000 000 000 000 000 000 000 000 000 154 155 035 036 036 036 036 036 036 036   036 036 037
000 000 000 000 000 000 000 000 000 000 000 000 000 000 000 000 000 000 000 000 000 000 000 000 000 000 000 000 000 000 000 000 000 000 000 000 000 000 000 000 000 000 000 000 000 000 000 000 000 000 000 000 000 000 000 000 000 000 000 000 000 000 000 000 000 000 000 000 000 000 000 000 000 000 000 000 000 000 000 000 000 000 000 000 000 000 000 156 157 035 036 036 036 036 036 036 036   036 036 037
000 000 000 000 000 000 000 000 000 000 000 000 000 000 000 000 000 000 000 000 000 000 000 000 000 000 000 000 000 000 000 000 000 000 000 000 000 000 000 000 000 000 000 000 000 000 000 000 000 000 000 000 000 000 000 000 000 000 000 000 000 000 000 000 000 000 000 000 000 000 000 000 000 000 000 000 000 000 000 000 000 000 000 000 000 000 000 000 000 035 036 036 036 036 036 036 036   036 036 037
000 000 000 000 000 000 000 000 000 000 000 000 000 000 000 000 000 000 000 000 000 000 000 000 000 000 000 000 000 000 000 000 000 000 000 000 000 000 000 000 000 000 000 000 000 000 000 000 000 000 000 000 000 000 000 000 000 000 000 000 000 000 000 000 000 000 000 000 000 000 000 000 000 000 000 000 000 000 000 000 000 000 000 000 000 000 000 154 155 035 036 140 141 142 143 144 145   146 036 037
000 000 000 000 000 000 000 000 000 000 000 000 000 000 000 000 000 000 000 000 000 000 000 000 000 000 000 000 000 000 000 000 000 000 000 000 000 000 000 000 000 000 000 000 000 000 000 000 022 017 017 017 017 017 017 018 017 017 017 017 017 017 017 017 017 017 017 018 023 000 000 000 000 000 000 000 000 000 000 000 000 000 000 000 000 000 000 156 157 035 036 147 148 149 150 151 152   153 036 037
000 000 000 000 000 000 000 000 000 000 000 000 000 000 000 000 000 000 000 000 000 000 000 000 000 000 000 000 000 000 000 000 000 000 000 000 000 000 000 000 000 000 000 000 000 000 000 000 022 177 017 018 177 177 017 177 017 177 017 177 017 177 017 177 177 018 017 177 023 000 000 000 000 000 000 000 000 000 000 000 000 000 000 000 000 000 000 000 000 035 036 036 036 036 036 036 036   036 036 037
000 000 000 000 000 000 000 000 000 000 000 000 000 000 000 000 000 000 000 000 000 000 000 000 000 000 000 000 000 000 000 000 000 000 000 000 000 000 000 000 000 000 000 000 000 000 000 000 022 178 017 017 179 179 017 178 017 177 018 177 017 178 017 179 179 017 017 178 023 000 000 000 000 000 000 000 000 000 000 000 000 000 000 000 000 000 000 154 155 035 036 036 036 036 036 036 036   036 036 037
000 000 000 000 000 000 000 000 000 000 000 000 131 134 132 135 000 000 000 000 000 000 000 000 000 000 000 000 000 000 000 000 000 000 000 000 000 000 000 000 000 000 000 000 000 000 000 000 022 017 017 017 017 017 017 017 017 018 017 017 017 017 017 017 017 017 017 017 023 000 000 000 000 000 000 000 000 000 000 000 000 000 000 000 000 000 000 156 157 035 036 036 036 036 036 036 036   036 036 037 
000 000 000 000 000 000 000 000 131 132 132 132 132 132 132 132 132 132 132 135 000 000 000 000 000 000 000 000 000 000 000 000 000 000 000 000 000 000 000 000 000 000 000 000 000 000 000 000 022 177 017 017 177 177 018 177 017 177 017 177 017 177 017 177 177 018 017 177 023 000 000 000 000 000 000 000 000 000 000 000 000 000 000 000 000 000 000 000 000 035 036 036 036 036 036 036 036   036 036 037
000 000 000 000 131 132 132 132 133 132 134 132 133 133 132 133 134 132 132 132 132 132 132 135 000 000 000 000 000 000 000 000 000 000 000 000 000 000 000 000 000 000 000 000 000 000 000 000 022 179 017 017 179 179 018 179 017 177 017 177 017 179 017 179 179 017 017 179 023 000 000 000 000 000 000 000 000 000 000 000 000 000 000 000 000 000 000 000 000 035 036 036 036 036 036 036 036   036 036 037
131 132 132 132 132 069 072 075 132 132 132 132 132 134 132 134 132 133 132 134 132 132 132 133 132 132 132 135 000 000 000 000 000 000 000 000 000 000 000 000 000 000 000 000 000 000 000 000 022 018 017 017 017 017 017 017 017 017 017 017 018 017 017 017 017 017 017 017 023 000 000 000 000 000 000 000 000 000 000 000 000 000 000 000 000 000 000 000 000 035 036 036 036 036 036 036 036   036 036 037
131 133 132 132 132 071 074 076 132 132 132 134 132 132 134 132 132 132 132 132 132 133 132 132 132 133 132 135 000 000 000 000 000 000 000 000 000 000 000 000 000 000 000 000 000 000 000 000 022 177 017 017 177 177 017 177 017 177 017 177 017 177 017 177 177 017 018 177 023 000 000 000 000 000 000 000 000 000 000 000 000 000 000 000 000 000 000 000 000 035 036 036 036 036 036 036 036   036 036 037
131 132 132 133 132 132 136 132 132 133 132 133 132 132 133 132 134 132 132 132 134 133 133 132 134 132 132 135 000 000 000 000 000 000 000 000 000 000 000 000 000 000 000 000 000 000 000 000 022 178 017 017 178 178 017 179 017 177 018 177 017 179 017 178 178 017 018 178 023 000 000 000 000 000 000 000 000 000 000 000 000 000 000 000 000 000 000 000 000 035 036 036 036 036 036 036 036   036 036 037
131 132 132 132 132 079 082 085 134 133 132 132 134 132 132 133 132 132 132 132 132 132 132 132 132 132 132 135 000 000 000 000 000 000 000 000 000 000 000 000 000 000 000 000 000 000 000 000 022 017 017 017 018 017 017 017 017 019 017 019 017 017 017 018 017 017 017 017 023 000 000 000 000 000 000 000 000 000 000 000 000 000 000 000 000 000 000 000 000 035 036 036 036 036 036 036 045   036 036 037
131 132 132 134 132 080 083 086 132 132 134 132 132 132 132 132 132 132 133 132 132 132 134 132 132 132 133 135 160 161 160 161 160 161 160 161 160 161 160 161 160 161 160 161 160 161 160 161 022 177 018 017 177 177 017 177 017 020 017 020 017 177 018 177 177 017 017 177 023 158 159 158 159 158 159 158 159 158 159 158 159 158 159 158 159 158 159 158 159 035 036 036 036 036 036 036 044 65582 036 037
128 129 129 129 129 137 138 139 129 129 129 129 129 129 129 129 129 129 129 129 129 129 129 129 129 129 129 130 040 040 040 040 040 040 040 040 040 040 040 040 040 040 040 040 040 040 040 040 004 004 004 004 004 004 004 004 004 006 004 006 004 004 004 004 004 004 004 004 004 039 039 039 039 039 039 039 039 039 039 039 039 039 039 039 039 039 039 039 039 029 030 030 030 030 030 030 043   030 030 031
000 000 000 000 000 000 000 000 000 000 000 000 000 000 000 000 000 000 000 000 000 000 000 000 000 000 000 000 000 000 000 000 000 000 000 000 000 000 000 000 000 000 000 000 000 000 000 000 000 000 000 000 000 000 000 000 000 000 000 000 000 000 000 000 000 000 000 000 000 000 000 000 000 000 000 000 000 000 000 000 000 000 000 000 000 000 000 000 000 000 000 000 000 000 000 000 000   000 000 000
000 000 000 000 000 000 000 000 000 000 000 000 000 000 000 000 000 000 000 000 000 000 000 000 000 000 000 000 000 000 000 000 000 000 000 000 000 000 000 000 000 000 000 000 000 000 000 000 000 000 000 000 000 000 000 000 000 000 000 000 000 000 000 000 000 000 000 000 000 000 000 000 000 000 000 000 000 000 000 000 000 000 000 000 000 000 000 000 000 000 000 000 000 000 000 000 000   000 000 000
;                                                                                                                                                                                                                                                                                                                                                                                                     
001 001 001 001 001 001 001 001 001 001 001 001 001 001 001 001 001 001 001 001 001 001 001 001 001 001 001 001 001 001 001 001 001 001 001 001 001 001 001 001 001 001 001 001 001 001 001 001 001 001 001 001 001 001 001 001 001 001 001 001 001 001 001 001 001 001 001 001 001 001 001 001 001 001 001 001 001 001 001 001 001 001 001 001 001 001 001 001 001 001 001 001 001 001 001 001 001   001 001 001 
001 000 000 000 000 000 000 000 000 000 000 000 000 000 000 000 000 000 000 000 000 000 000 000 000 000 000 000 000 000 000 000 000 000 000 000 000 000 000 000 000 000 000 000 000 000 000 000 000 000 000 000 000 000 000 000 000 000 000 000 000 000 000 000 000 000 000 000 000 000 000 000 000 000 000 000 000 000 000 000 000 000 000 000 000 000 000 000 000 000 000 000 000 000 000 000 000   000 000 001
001 000 000 000 000 000 000 000 000 000 000 000 000 000 000 000 000 000 000 000 000 000 000 000 000 000 000 000 000 000 000 000 000 000 000 000 000 000 000 000 000 000 000 000 000 000 000 000 000 000 000 000 000 000 000 000 000 000 000 000 000 000 000 000 000 000 000 000 000 000 000 000 000 000 000 000 000 000 000 000 000 000 000 000 000 000 000 000 000 000 000 000 000 000 000 000 000   000 000 001
001 000 000 000 000 000 000 000 000 000 000 000 000 000 000 000 000 000 000 000 000 000 000 000 000 000 000 000 000 000 000 000 000 000 000 000 000 000 000 000 000 000 000 000 000 000 000 000 000 000 000 000 000 000 000 000 000 000 000 000 000 000 000 000 000 000 000 000 000 000 000 000 000 000 000 000 000 000 000 000 000 000 000 000 000 000 000 000 000 000 000 000 000 000 000 000 000   000 000 001
001 000 000 000 000 000 000 000 000 000 000 000 000 000 000 000 000 000 000 000 000 000 000 000 000 000 000 000 000 000 000 000 000 000 000 000 000 000 000 000 000 000 000 000 000 000 000 000 000 000 000 000 000 000 000 000 000 000 000 000 000 000 000 000 000 000 000 000 000 000 000 000 000 000 000 000 000 000 000 000 000 000 000 000 000 000 000 000 000 000 000 000 000 000 000 000 000   000 000 001
001 000 000 000 000 000 000 000 000 000 000 000 000 000 000 000 000 000 000 000 000 000 000 000 000 000 000 000 000 000 000 000 000 000 000 000 000 000 000 000 000 000 000 000 000 000 000 000 000 000 000 000 000 000 000 000 000 000 000 000 000 000 000 000 000 000 000 000 000 000 000 000 000 000 000 000 000 000 000 000 000 000 000 000 000 000 000 000 000 000 000 000 000 000 000 000 000   000 000 001
001 000 000 000 000 000 000 000 000 000 000 000 000 000 000 000 000 000 000 000 000 000 000 000 000 000 000 000 000 000 000 000 000 000 000 000 000 000 000 000 000 000 000 000 000 000 000 000 000 000 000 000 000 000 000 000 000 000 000 000 000 000 000 000 000 000 000 000 000 000 000 000 000 000 000 000 000 000 000 000 000 000 000 000 000 000 000 000 000 000 000 000 000 000 000 000 000   000 000 001
001 000 000 000 000 000 000 000 000 000 000 000 000 000 000 000 000 000 000 000 000 000 000 000 000 000 000 000 000 000 000 000 000 000 000 000 000 000 000 000 000 000 000 000 000 000 000 000 000 000 000 000 000 000 000 000 000 000 000 000 000 000 000 000 000 000 000 000 000 000 000 000 000 000 000 000 000 000 000 000 000 000 000 000 000 000 000 000 000 000 000 000 000 000 000 000 000   000 000 001
001 000 000 000 000 000 000 000 000 000 000 000 000 000 000 000 000 000 000 000 000 000 000 000 000 000 000 000 000 000 000 000 000 000 000 000 000 000 000 000 000 000 000 000 000 000 000 000 000 000 000 000 000 000 000 000 000 000 000 000 000 000 000 000 000 000 000 000 000 000 000 000 000 000 000 000 000 000 000 000 000 000 000 000 000 000 000 000 000 000 000 000 000 000 000 000 000   000 000 001
001 000 000 000 000 000 000 000 000 000 000 000 000 000 000 000 000 000 000 000 000 000 000 000 000 000 000 000 000 000 000 000 000 000 000 000 000 000 000 000 000 000 000 000 000 000 000 000 000 000 000 000 000 000 000 000 000 000 000 000 000 000 000 000 000 000 000 000 000 000 000 000 000 000 000 000 000 000 000 000 000 000 000 000 000 000 000 000 000 000 000 000 000 000 000 000 000   000 000 001
001 000 000 000 000 000 000 000 000 000 000 000 000 000 000 000 000 000 000 000 000 000 000 000 000 000 000 000 000 000 000 000 000 000 000 000 000 000 000 000 000 000 000 000 000 000 000 000 000 000 000 000 000 000 000 000 000 000 000 000 000 000 000 000 000 000 000 000 000 000 000 000 000 000 000 000 000 000 000 000 000 000 000 000 000 000 000 000 000 000 000 000 000 000 000 000 000   000 000 001
001 000 000 000 000 000 000 000 000 000 000 000 000 000 000 000 000 000 000 000 000 000 000 000 000 000 000 000 000 000 000 000 000 000 000 000 000 000 000 000 000 000 000 000 000 000 000 000 000 000 000 000 000 000 000 000 000 000 000 000 000 000 000 000 000 000 000 000 000 000 000 000 000 000 000 000 000 000 000 000 000 000 000 000 000 000 000 000 000 000 000 000 000 000 000 000 000   000 000 001 
001 000 000 000 000 000 000 000 000 000 000 000 000 000 000 000 000 000 000 000 000 000 000 000 000 000 000 000 000 000 000 000 000 000 000 000 000 000 000 000 000 000 000 000 000 000 000 000 000 000 000 000 000 000 000 000 000 000 000 000 000 000 000 000 000 000 000 000 000 000 000 000 000 000 000 000 000 000 000 000 000 000 000 000 000 000 000 000 000 000 000 000 000 000 000 000 000   000 000 001
001 000 000 000 000 000 000 000 000 000 000 000 000 000 000 000 000 000 000 000 000 000 000 000 000 000 000 000 000 000 000 000 000 000 000 000 000 000 000 000 000 000 000 000 000 000 000 000 000 000 000 000 000 000 000 000 000 000 000 000 000 000 000 000 000 000 000 000 000 000 000 000 000 000 000 000 000 000 000 000 000 000 000 000 000 000 000 000 000 000 000 000 000 000 000 000 000   000 000 001
001 000 000 000 000 000 000 000 000 000 000 000 000 000 000 000 000 000 000 000 000 000 000 000 000 000 000 000 000 000 000 000 000 000 000 000 000 000 000 000 000 000 000 000 000 000 000 000 000 000 000 000 000 000 000 000 000 000 000 000 000 000 000 000 000 000 000 000 000 000 000 000 000 000 000 000 000 000 000 000 000 000 000 000 000 000 000 000 000 000 000 000 000 000 000 000 000   000 000 001
001 000 000 000 000 000 000 000 000 000 000 000 000 000 000 000 000 000 000 000 000 000 000 000 000 000 000 000 000 000 000 000 000 000 000 000 000 000 000 000 000 000 000 000 000 000 000 000 000 000 000 000 000 000 000 000 000 000 000 000 000 000 000 000 000 000 000 000 000 000 000 000 000 000 000 000 000 000 000 000 000 000 000 000 000 000 000 000 000 000 000 000 000 000 000 000 000   000 000 001
001 000 000 000 000 000 000 000 000 000 000 000 000 000 000 000 000 000 000 000 000 000 000 000 000 000 000 000 000 000 000 000 000 000 000 000 000 000 000 000 000 000 000 000 000 000 000 000 000 000 000 000 000 000 000 000 000 000 000 000 000 000 000 000 000 000 000 000 000 000 000 000 000 000 000 000 000 000 000 000 000 000 000 000 000 000 000 000 000 000 000 000 000 000 000 000 000   000 000 001
001 000 000 000 000 000 000 000 000 000 000 000 000 000 000 000 000 000 000 000 000 000 000 000 000 000 000 000 000 000 000 000 000 000 000 000 000 000 000 000 000 000 000 000 000 000 000 000 000 000 000 000 000 000 000 000 000 000 000 000 000 000 000 000 000 000 000 000 000 000 000 000 000 000 000 000 000 000 000 000 000 000 000 000 000 000 000 000 000 000 000 000 000 000 000 000 000   000 000 001
007 007 007 007 007 007 007 007 007 008 007 007 007 007 007 007 007 007 007 007 007 007 007 007 007 007 007 007 007 008 007 007 007 007 007 007 007 007 007 007 007 007 007 007 007 007 007 007 007 008 007 007 007 007 007 007 007 007 007 007 007 007 007 007 007 007 007 007 007 008 007 007 007 007 007 007 007 007 007 007 007 007 007 007 007 007 007 007 007 008 007 007 007 007 007 007 007   007 007 007
009 009 009 009 009 009 009 009 010 009 009 009 009 009 009 009 009 009 009 009 009 009 009 009 009 009 009 009 010 009 009 009 009 009 009 009 009 009 009 009 009 009 009 009 009 009 009 009 010 009 009 009 009 009 009 009 009 009 009 009 009 009 009 009 009 009 009 009 010 009 009 009 009 009 009 009 009 009 009 009 009 009 009 009 009 009 009 009 010 009 009 009 009 009 009 009 009   009 009 009
;                                                                                                                                                                                                                                                                                                                                                                                                     
000 000 000 000 000 000 000 000 000 000 000 000 000 000 000 000 000 000 000 000 000 000 000 000 000 000 000 000 000 000 000 000 000 000 000 000 000 000 000 000 000 000 000 000 000 000 000 000 000 000 000 000 000 000 000 000 000 000 000 000 000 000 000 000 000 000 000 000 000 000 000 000 000 000 000 000 000 000 000 000 000 000 000 000 000 000 000 000 000 000 000 000 000 000 000 000 000   000 000 000 
000 000 000 000 000 000 000 000 000 000 000 000 000 000 000 000 000 000 000 000 000 000 000 000 000 000 000 000 000 000 000 000 000 000 000 000 000 000 000 000 000 000 000 000 000 000 000 000 000 000 000 000 000 000 000 000 000 000 000 000 000 000 000 000 000 000 000 000 000 000 000 000 000 000 000 000 000 000 000 000 000 000 000 000 000 000 000 000 000 000 000 000 000 000 000 000 000   000 000 000
000 000 000 000 000 000 000 000 000 000 000 000 000 000 000 000 000 000 000 000 000 000 000 000 000 000 000 000 000 000 000 000 000 000 000 000 000 000 000 000 000 000 000 000 000 000 000 000 000 000 000 000 000 000 000 000 000 000 000 000 000 000 000 000 000 000 000 000 000 000 000 000 000 000 000 000 000 000 000 000 000 000 000 000 000 000 000 000 000 000 000 000 000 000 000 000 000   000 000 000
000 000 000 000 000 000 000 000 000 000 000 000 000 000 000 000 000 000 000 000 000 000 000 000 000 000 000 000 000 000 000 000 000 000 000 000 000 000 000 000 000 000 000 000 000 000 000 000 000 000 000 000 000 000 000 000 000 000 000 000 000 000 000 000 000 000 000 000 000 000 000 000 000 000 000 000 000 000 000 000 000 000 000 000 000 000 000 000 000 000 000 000 000 000 000 000 000   000 000 000
000 000 000 000 000 000 000 000 000 000 000 000 000 000 000 000 000 000 000 000 000 000 000 000 000 000 000 000 000 000 000 000 000 000 000 000 000 000 000 000 000 000 000 000 000 000 000 000 000 000 000 000 000 000 000 000 000 000 000 000 000 000 000 000 000 000 000 000 000 000 000 000 000 000 000 000 000 000 000 000 000 000 000 000 000 000 000 000 000 000 000 000 000 000 000 000 000   000 000 000
000 000 000 000 000 000 000 000 000 000 000 000 000 000 000 000 000 000 000 000 000 000 000 000 000 000 000 000 000 000 000 000 000 000 000 000 000 000 000 000 000 000 000 000 000 000 000 000 000 000 000 000 000 000 000 000 000 000 000 000 000 000 000 000 000 000 000 000 000 000 000 000 000 000 000 000 000 000 000 000 000 000 000 000 000 000 000 000 000 000 000 000 000 000 000 000 000   000 000 000
000 000 000 000 000 000 000 000 000 000 000 000 000 000 000 000 000 000 000 000 000 000 000 000 000 000 000 000 000 000 000 000 000 000 000 000 000 000 000 000 000 000 000 000 000 000 000 000 000 000 000 000 000 000 000 000 000 000 000 000 000 000 000 000 000 000 000 000 000 000 000 000 000 000 000 000 000 000 000 000 000 000 000 000 000 000 000 000 000 000 000 000 000 000 000 000 000   000 000 000
000 000 000 000 000 000 000 000 000 000 000 000 000 000 000 000 000 000 000 000 000 000 000 000 000 000 000 000 000 000 000 000 000 000 000 000 000 000 000 000 000 000 000 000 000 000 000 000 000 000 000 000 000 000 000 000 000 000 000 000 000 000 000 000 000 000 000 000 000 000 000 000 000 000 000 000 000 000 000 000 000 000 000 000 000 000 000 000 000 000 000 000 000 000 000 000 000   000 000 000
000 000 000 000 000 000 000 000 000 000 000 000 000 000 000 000 000 000 000 000 000 000 000 000 000 000 000 000 000 000 000 000 000 000 000 000 000 000 000 000 000 000 000 000 000 000 000 000 000 000 000 000 000 000 000 000 000 000 000 000 000 000 000 000 000 000 000 000 000 000 000 000 000 000 000 000 000 000 000 000 000 000 000 000 000 000 000 000 000 000 000 000 000 000 000 000 000   000 000 000
000 000 000 000 000 000 000 000 000 000 000 000 000 000 000 000 000 000 000 000 000 000 000 000 000 000 000 000 000 000 000 000 000 000 000 000 000 000 000 000 000 000 000 000 000 000 000 000 000 000 000 000 000 000 000 000 000 000 000 000 000 000 000 000 000 000 000 000 000 000 000 000 000 000 000 000 000 000 000 000 000 000 000 000 000 000 000 000 000 000 000 000 000 000 000 000 000   000 000 000
000 000 000 000 000 000 000 000 000 000 000 000 000 000 000 000 000 000 000 000 000 000 000 000 000 000 000 000 000 000 000 000 000 000 000 000 000 000 000 000 000 000 000 000 000 000 000 000 000 000 000 000 000 000 000 000 000 000 000 000 000 000 000 000 000 000 000 000 000 000 000 000 000 000 000 000 000 000 000 000 000 000 000 000 000 000 000 000 000 000 000 000 000 000 000 000 000   000 000 000
000 000 000 000 000 000 000 000 000 000 000 000 000 000 000 000 000 000 000 000 000 000 000 000 000 000 000 000 000 000 000 000 000 000 000 000 000 000 000 000 000 000 000 000 000 000 000 000 000 000 000 000 000 000 000 000 000 000 000 000 000 000 000 000 000 000 000 000 000 000 000 000 000 000 000 000 000 000 000 000 000 000 000 000 000 000 000 000 000 000 000 000 000 000 000 000 000   000 000 000
000 000 000 000 000 000 000 000 000 000 000 000 000 000 000 000 000 000 000 000 000 000 000 000 000 000 000 000 000 000 000 000 000 000 000 000 000 000 000 000 000 000 000 000 000 000 000 000 000 000 000 000 000 000 000 000 000 000 000 000 000 000 000 000 000 000 000 000 000 000 000 000 000 000 000 000 000 000 000 000 000 000 000 000 000 000 000 000 000 000 000 000 000 000 000 000 000   000 000 000
000 000 000 000 000 000 000 000 000 000 000 000 000 000 000 000 000 000 000 000 000 000 000 000 000 000 000 000 000 000 000 000 000 000 000 000 000 000 000 000 000 000 000 000 000 000 000 000 000 000 000 000 000 000 000 000 000 000 000 000 000 000 000 000 000 000 000 000 000 000 000 000 000 000 000 000 000 000 000 000 000 000 000 000 000 000 000 000 000 000 000 000 000 000 000 000 000   000 000 000
000 000 000 000 028 000 000 000 000 000 000 000 000 000 028 000 000 000 000 000 000 000 000 000 028 000 000 000 000 000 000 000 000 000 028 000 000 000 000 000 000 000 000 000 028 000 000 000 000 000 000 000 000 000 028 000 000 000 000 000 000 000 000 000 028 000 000 000 000 000 000 000 000 000 028 000 000 000 000 000 000 000 000 000 028 000 000 000 000 000 000 000 000 000 028 000 000   000 000 000
000 000 000 000 027 000 000 000 000 000 000 000 000 000 027 000 000 000 000 000 000 000 000 000 027 000 000 000 000 000 000 000 000 000 027 000 000 000 000 000 000 000 000 000 027 000 000 000 000 000 000 000 000 000 027 000 000 000 000 000 000 000 000 000 027 000 000 000 000 000 000 000 000 000 027 000 000 000 000 000 000 000 000 000 027 000 000 000 000 000 000 000 000 000 027 000 000   000 000 000
000 000 000 000 026 000 000 000 000 000 000 000 000 000 026 000 000 000 000 000 000 000 000 000 026 000 000 000 000 000 000 000 000 000 026 000 000 000 000 000 000 000 000 000 026 000 000 000 000 000 000 000 000 000 026 000 000 000 000 000 000 000 000 000 026 000 000 000 000 000 000 000 000 000 026 000 000 000 000 000 000 000 000 000 026 000 000 000 000 000 000 000 000 000 026 000 000   000 000 000
000 000 000 000 025 000 000 000 000 000 000 011 000 000 025 000 000 000 000 000 000 000 000 000 025 000 000 000 000 000 000 011 000 000 025 000 000 000 000 000 000 000 000 000 025 000 000 000 000 000 000 011 000 000 025 000 000 000 000 000 000 000 000 000 025 000 000 000 000 000 000 011 000 000 025 000 000 000 000 000 000 000 000 000 025 000 000 000 000 000 000 011 000 000 025 000 000   000 000 000
000 000 000 000 024 000 000 000 000 000 000 012 000 000 024 000 000 000 000 000 000 000 000 000 024 000 000 000 000 000 000 012 000 000 024 000 000 000 000 000 000 000 000 000 024 000 000 000 000 000 000 012 000 000 024 000 000 000 000 000 000 000 000 000 024 000 000 000 000 000 000 012 000 000 024 000 000 000 000 000 000 000 000 000 024 000 000 000 000 000 000 012 000 000 024 000 000   000 000 000
000 000 000 000 000 000 000 000 000 000 000 000 000 000 000 000 000 000 000 000 000 000 000 000 000 000 000 000 000 000 000 000 000 000 000 000 000 000 000 000 000 000 000 000 000 000 000 000 000 000 000 000 000 000 000 000 000 000 000 000 000 000 000 000 000 000 000 000 000 000 000 000 000 000 000 000 000 000 000 000 000 000 000 000 000 000 000 000 000 000 000 000 000 000 000 000 000   000 000 000
;